R 1920 1080
S ./text/pics/coca.xpm
NO ./text/pics/dani.xpm
WE ./text/pics/tucos.xpm
EA ./text/pics/clari.xpm
SO ./text/pics/nat.xpm
C 16,35,
F 80,80,80

1111111111111111111111111111
1000000000000000000000000001
1020000000002000000000000001
100000S000000000002000000001
1020000000002000000000000001
1000000000000000002000002001
1020000200002000000002000001
1000000000000000002000000001
1000000000000000000000000001
1111111111111111111111111111